A..................B
..m.........m.......
...m.........m......
....m........m......
........www......m..
.......wwwww.....m..
........www.........
........ww..........
...m..........m.....
...mm.........mm....
.............mm.....
